**#***###*
#*#*#*****
#*###*#*##
#*****#***
#########*
#***#*****
**#***####
#*#####***
#*******#*
###*###*#*
